0000
000000000000000
000000000000000
000000000000000
000000000000001
111111000000010
000000000000100
000000000001000
000000000010000
000000000100000
000000000000000
000000000000000
000001000000000
000011110000000
000000011000000
000000111100000
000000000110000
100000000011111
000000000000000
000000000000000
000000000000000