0000
000000000000000
000000000000000
000000000000000
010001111100000
000000000000000
010000000000000
000000000000000
000000000000001
000001110000000
000000000000001
000000000010000
000000000000001
000000000000000
111111000000000
000000000001110
000000000000000
000000000000000
000000010000000
000000000000000
000000000000000